europe = {
	3966 3967 3991 3992 3993 3994 3995 3996 4022 4023 4024
	3839 3838 3837 3836 3883 3840 3841 3151 2334 3046
	3485 3486 3487 3488 3489 3490 3491 3492 3493 3494 3495 3496 3497 3498 3499 3758 3759 3760 3761 3762
	3763 3764 3765 3766 3767 5033 5112
	#Scandinavia
	1 2 3 4 5 6 7 8 9 10 11 12 13 14 15 16 17 18 19 20 21 22 23 24 25 26 27 28 29 30 31
	1930 1981 1982 1983 1984 1985 2752 3722 3753 781 3775
	4401 4402 4403 4404 4405 4406 4967 4968
	#Baltic Coast
	32 33 34 35 36 37 38 39 40 41 42 43 767 770 1834 1841 1842 1935
	#Germany
	44 45 46 47 48 49 50 51 52 53 54 55 56 57 58 59 60 61 62 63 64 65 66 67 68 69 70 71
	72 73 74 75 76 77 78 79 80 81 82 83 84 85 86 128 129 130 131 132 133 134 165 166 1757
	1758 1759 1760 1761 1762 1763 1769 1770 1771 1772 1775 1857 1858 1863 1867 1868 1869
	1870 1871 1872 1873 1874 1876 1878 1880 1931 2955 2956 2957 2964 3676
	2965 2966 2967 2968 2969 2970 2971 2972 2973 2975 2993 2994 2995 2996 3153 3667
	4407 4408 4415 4417 4418 4419 4420 4421 4422 4423 4424 4425 4426 4427 4445 4446
	4478 4479 4480 4481 4482 4483 4484 4485 4486 4487 4488 4489 4490 4491 4492 4493 4495
	4496 4497 4498 4499 4500 4501 4502 4503 4504 4505 4506 4507 4508 4509 4510 4511 4512
	4513 4514 4515 4516 4517 4518 4519 4520 4521 4770 4772 4934 4935 4939 4970 5007 5025
	5026 5027 5028 5029 5030 5031 5075 5084 5085 5086 5087 5088 5089 5090 5091 5092 5109
	#Lowlands 
	87 88 89 90 91 92 93 94 95 96 97 98 99 100 1742 1743 1744 1865 1866 2974
	#Italy
	101 102 103 104 105 106 107 108 109 110 111 112 113 114 115 116 117 118 119 120 121
	122 123 124 125 126 127 1774 1862 1875 1933 1934
	2976 2977 2978 2979 2980 2981 2982 2983 2984 2985 2986 2992
	4447 4448 4449 4450 4451 4452 4453 4454 4455 4456 4457 4458 4459 4460 4461 4462 4463
	4464 4769 4881 4882 4969 5017 5018 5019 5020 5021 5078 5079 5080 5081 5082 5083
	#Balkans
	135 136 137 138 139 140 141 142 143 144 145 146 147 148 149 150 151 152 153 154 155
	156 157 158 159 160 161 162 163 164 1756 1764 1765 1766 1767 1768 1826 1827 1828 1831
	1864 1951 1952 1953 1954 2348 2746 2750 1318 2998 3000 3001 3002 3779 3780 3803
	3781 3782 3783 3784 3785 3786 3787
	4416 4435 4436 4437 4438 4439 4440 4441 4442 4443 4444 4522 4537 4538 4858 4859 4860
	4861 4862 4863 4864 4866 4867 4927 4936 4937 4938 4948
	#France
	167 168 169 170 171 172 173 174 175 176 177 178 179 180 181 182 183 184 185 186 187 2863
	188 189 190 191 192 193 194 195 196 197 198 199 200 201 202 203 204 205 1877 1879 2753 2991
	3152 3665 4906
	4085 4465 4466 4467 4468 4469 4470 4471 4472 4473 4474 4475 4476 4477 5035 5036 5037 5038 5039
	5040 5041 5042 5043 5044 5102 5103 5104 5105 5106 5107 5108
	#Iberia
	206 207 208 209 210 211 212 213 214 215 216 217 218 219 220 221 222 223 224 225 226
	227 228 229 230 231 232 333 1745 1746 1747 1748 1749 1750 1851 2751 2754 2755
	2987 2988 2989 2990 4057
	4494 4532 4533 4534 4535 4536 4781 4883 4884 4885 4928 4929 4930 4931 4932 4933 5009
	#British isles
	233 234 235 236 237 238 239 240 241 242 243 244 245 246 247 248 249 250 251 252 253
	1860 1861
	4267 4523 4524 4525 4526 4527 4528 4529 4530 4531 4767 4768 4880 5014 5015
	#Poland
	254 255 256 257 258 259 260 261 262 263 264 265 266 267 268 269 270 271 272 273 274
	275 276 277 278 279 280 281 1859 1936 1937 1938 1939 1940 1941 1942 1943 1944 1945 2405 2424
	2958 2959 2960 2961 2962 2963 2997 3134 3669 3674 2672
	4409 4410 4411 4412 4413 4414 4865 4940 4941 4942 4943 4944 4945 4946 4947 4949 4950 4951 4952
	4953 4954 4955 4956 4957 4958 5008
	#Russia
	282 283 284 285 286 287 288 289 290 291 292 293 294 295 296 297 298 299 300 301 302
	303 304 305 306 307 308 309 310 311 312 313 314 315 1752 1753 1754 1755 1776 1777 1778
	1780 1955 1956 1957 1958 1959 1960 1961 1962 1963 1964 1965 1974 2444
	475 1972 473 474 469 464 425 463 462 1856 468 466 1971 467 771
	4336 4337 4338 4339 4340 4341 4342 4343 4344 4345 4346 4347 4348 4349 4350 4351 4352 4353 4354
	4355 4356 4357 4358 4359 4363 4364 4365 4366 4367 4368 4369 4370 4371 4372 4373 4374 4375 4376
	4377 4378 4379 4380 4381 4382 4383 4384 4385 4386 4387 4388 4389 4390 4391 4392 4393 4394 4395
	4396 4397 4398 4399 4400 4959 4960 4908 4909 4910 4911 4961 4962 4963 4964 4965 4966 4972
	#Russian new provinces
	2406 2407 2408 2409 2410 2411 2412 2413 2414 2415 2416 2417 2418 2419 2420 2421 2422 2423 2425 2447 2749 2441 3777 3569
	#Turkey
	316 317 318 319 320 321 322 323 324 325 326 327 328 329 330 331 332 1846 1848	
	2296 2297 2298 2299 2300 2301 2302 2303 2304 2305 3107 3108 3109 3110 3111 3112 3113 3114 
	3122 3123 3124 3125 3126 3127 3128 3129 3130 3131 3132 3133 3254 3255 3006 3007 3018 3477 3478 3479 3480 3842
	4362 4428 4429 4430 4431 4432 4433 4434 5006 5032 5093
	#Atlantic islands
	367 369 370 371 372 373 374 375 376 1978 1979
	#More bits of Russia
	1077 1079 1081 1082 1083 423
	#Island
	1247
	#More bits of Greece
	1773 1853 3003 3481 3482
	#Persia changes
	422 2195 2196 2197 2198 2199 2201 2203 2204 2208 
	4360 4361
	
	1323 #Crimea Trade Node
	1320 #Constantinople Tradenode
	1297 #Genoa
	1926 #Baltic
	1652 #WhiteSea
	1293 #Sevilla
	1276 #Bourdaux
	1281 #North Sea
	1308 #Venice
	
	2365 2367 2366 
	3004 3005 3008 3009 3010 3011 3012 3013 3014 3015 3016 3017 3019 3020 3021 3022 3023 3024 3025 3026 3027 3028 3029 3030 3031 3032 3033 3034 3035 3036 3037 3038 3039 3040 3041 3042 3043 3044 3045 3047 3048 3049 3050 3051 3052 3053 3054 3055 3056 3057 3058 3059 3060 3061 3062 3063 3064 3065 3066 3067 3068 3069 3070 3071 3072 3073 3074 3075 3076 3077 3078 3079 3080 3081 3082 3083 3084 3085 3086 3087 3088 3089 3090 3091 3092 3093 3094 3095 3096 3097 3098 3099 3100 3101 3102 3103 3104 3105 3106
	
	3154 3155 3157 3158 3159 3160 3161 3162 3163 3164 3165 3166 3167 3168 3169 3170 3171 3172 3173 3174 3175 3176 3177 3178 3179 3180 3181 3182 3183 3184 3186 3187 3188 3189 3190 3191 3192 3193 3194 3195 3196 3197
	3198 3199 3200 3202 3204 3205 3206 3207 3208 3209 3210 3211 3212 3213 3214 3215 3216 3217 3218 3219 3220 3221 3222 3145 3146 3147 3148 3149 3150 3223 3224 3225 3226
    3227 3228 3229 3230 3231 3232 3233 3234 3235 3236 3237 3238 3239 3240 3241 3242 3243 3244 3245 3246 3247 3248 3249
	3257 3258 3259 3260 3261 3262 3263 3264 3265 3273 3274 3275 3276 3277 3278 3279 3280 3281 3282 3283 3284 3285 3286 3287 3288 3289 3290
	3411 3412 3723 3724 3725 3726 3727 3728 3742 3744 3745 3746 3819 3805 3806 3807 3808 3809 3811 3812 3821 3822 3823 5022 5023 5024 5034 5045 5046 5047 5048 5049 5050 5051 5052 5053 5054 5055 5056 5057 5058 5059 5060 5061 5062 5063 5064 5065 5066 5067 5068 5069 5070 5071 5072 5073 5074 5076 5077 5094 5095 5096 5097 5098 5099 5100 5101
	#Greenland
	1104 1105 1804 3185 3413
	5119 5120 5122
}

asia = {
	3957 3958 3959 3960 3961 3962 3963 3964 3965 3997 3998 3999 4000 4001 4002 4006 4007 4008 4009
	4010 4011 4012 4013 4014 4015 4016 4017 4018 4019 4020 4021
	3843 3844 3845 3846 3253 3798 3937 3956 3955 3850 3940 3938 3851 3939 3936 3942
	3941 3943 3944 3945 3946 3947 3953 3952 3949 3950 3951 3948
	#Middle east + central asia
	377 378 379 380 381 382 383 384 385 386 387 388 389 390 391 392 393 394 395 396 397
	398 399 400 401 402 403 404 405 406 407 408 409 410 411 412 413 414 415 416 417 418
	419 420 421 424 426 427 428 429 430 431 432 433 434 435 436 437 438 439
	440 441 442 443 444 445 446 447 448 449 450 451 452 453 454 455 456 457 458 459 460
	461 465 470 471 472 476 477 478 479 480 1779 1078 1080 1970 1973
	2306 2307 2308 2309 2310 2311 2312 2313 2314 2327 2328 2329 2330 2331 2332 2333
	2335 2336 2337 2338 2339 2340 2341 2342 2343 2344 2345 2346 2347
	3115 3116 3118 3119 3120 3121 3117 3622 3776 3799 3796 3797 3791 3801 3795 3156 3778
	3800
	4247 4248 4249 4250 4251 4252 4260 4262 4264 4265 4266 4268 4270 4271 4272 4274 4279
	4280 4281
	4333 4334
	#Persia changes
	2202 2205 2206 2207 2209 2210 2211 2212 2213 2214 2215 2216 2217 2218 2219 2220 2221
	2222 2223 2224 2225 2226 2227 2228 2229 2230 2231 2232 2233 2234 2235 2236 2200 2999
	4200 4201 4202 4203 4204 4205 4206 4207 4208 4209 4210 4211 4212 4213 4214 4215 4216
	4217 4218 4222 4224 4225 4226 4228 4229 4230 4231 4232 4233 4234 4235 4236 4239 4240
	4241 4242 4243 4901 4902 4903 4984
	#India
	503 504 505 506 507 508 509 510 511 512 513 514 515 516 517 518 519 520 521 522 523
	524 525 526 527 528 529 530 531 532 533 534 535 536 537 538 539 540 541 542 543 544
	545 546 547 548 549 550 551 552 553 554 555 556 557 558 559 560 561 562 563 564 565
	566 567 568 569 570 571 572 573 574 575 576 577 578 1913 1946 1947 1948 1949 1950
	2026 2027 2028 2029 2030 2031 2032 2033 2034 2035 2036 2037 2038 2039 2040 2041 2042
	2043 2044 2045 2046 2047 2048 2049 2050 2051 2052 2053 2054 2055 2056 2057 2058 2059
	2060 2061 2062 2063 2064 2065 2066 2067 2068 2069 2070 2071 2072 2073 2074 2075 2076
	2077 2078 2079 2080 2081 2082 2083 2084 2085 2086 2087 2088 2089 2090 2091 2092 2093
	2094 2095 2096 2097 2098 2099 2100 2101
	3135 3136
	4088 4089 4090 4091 4092 4093 4094 4095 4096 4097 4098 4099 4100 4101 4102 4103 4104
	4105 4106 4107 4108 4109 4110 4111 4112 4113 4114 4115 4116 4117 4118 4119 4120 4121
	4122 4123 4124 4125 4126 4127 4128 4129 4130 4131 4132 4133 4134 4135 4136 4137 4138
	4139 4140 4141 4142 4143 4144 4145 4146 4147 4148 4149 4150 4161 4162 4163 4164 4165
	4166 4167 4168 4169 4170 4171 4172 4173 4174 4175 4176 4177 4178 4179 4180 4181 4182
	4183 4184 4185 4186 4187 4188 4189 4190 4191 4192 4193 4194 4195 4196 4197 4198 4199
	4151 4152 4153 4154 4155 4156 4157 4158 4159 4160 4886 4887 4888 4889 4890
	#South East Asia
	579 580 581 582 583 584 585 586 587 588 589 590 591 592 593 594 595 596 597 598 599
	600 601 602 603 604 605 606 607 608 609 610 611 612 613 614 615 616 617 618 619 620
	621 622 623 624 625 626 627 628 629 630 631 632 633 634 635 636 637 638 639 640 641
	642 643 644 645 646 647 648 649 650 651 652 653 654 655 656 657 658 659 660 661
	1016 1022 1815 1817 1823 1915 1916 1923
	4892 4893 4904 4905
	# Additional Provinces in Indochina & Indonesia
	2371 2372 2373 2374 2375 2376 2377 2378 2379 2380 2381 2382 2383 2384 2385 2386 2387
	2388 2389 2390 2391 2392 2393 2394 2395 2396 2397 2398 2399 2400 2401 2402 2403 2404
	2673 2674 2675 2676 2677 2678 2679 2680 2681 2682 2683 2684 2685 2686 2687 2688 2689
	2690 2691 2692 2693 2694 2695 2696 2697 2698 2699 2700 2701 2702 2703 2704 2705 2706
	2707 2708 2709 2710 2711 2712 2713 2714 2715 2716 2717 2725 3256
	4026 4027 4028 4029 4030 4031 4032 4033 4034 4035 4036 4037 4038 4039 4040 4041 4042
	4043 4044 4045 4046 4047 4048 4049 4050 4051 4052 4053 4054 4055 4056 4058 4059
	4060 4061 4062 4063 4064 4065 4066 4067 4068 4069 4070 4071 4072 4073 4074 4075 4076
	4077 4078 4079 4080 4081 4082 4083 4084 4086 4087 4261 4263 4269 4273 4275 4277 4278
	4219 4220 4221 4223 4227 4237 4238 4244 4245 4246 4253 4254 4255 4256 4257 4258 4259
	4758 4760 4891 4894 4895 4896 4897 5001 5002 5003 5004 5005
	5013
	#China and Places like that
	662 663 664 665 666 667 668 669 670 671 672 673 674 675 676 677 678 679 680 681 682
	683 684 685 686 687 688 689 690 691 692 693 694 695 696 697 698 699 700 701 702 703
	704 705 706 707 708 709 710 711 712 713 714 715 716 717 718 719 720 721 722 723 724
	725 726 727 728 729 730 731 732 733 734 735 736 737 738 739 740 1784 1785 1786 1787
	1788 1816 1821 1822 1824 1829 1833 1836 1838 1850
	#New Greater China region provs
	2102 2103 2104 2105 2106 2107 2108 2109 2110 2111 2112 2113 2114 2115 
	2116 2117 2118 2119 2120 2121 2122 2123 2124 2125 2126 2127 2128 2129 
	2130 2131 2132 2133 2134 2135 2136 2137 2138 2139 2140 2141 2142 2143 
	2144 2145 2146 2147 2148 2149 2150 2151 2152 2153 2154 2155 2156 2157 
	2158 2159 2160 2161 2162 2163 2164 2165 2166 2167 2168 2169 2170 2171 
	2172 2173 2174 2175 2176 2177 2178 2179 2180 2181 2182 2183 2184 2185 
	2186 2187 2188 2189 2190 2191 2192 2193 2194 2741 2742 2743 2744 2745
	2747 2748 
	3251 3252 3802 3847 3848 3849 3852 3853 3854 3855 3856 3857 3882
	4285 4286 4287 4288 4289 4290 4291 4292 4293 4294 4295 4296
	4297 4298 4299 4300 4301 4302 4303 4304 4305 4306 4307 4308 4309 4310
	4311 4312 4313 4314 4315 4316 4317 4318 4907 4987 4997 4998 4999 5000
	#Japan and the far east
	1012 1013 1014 1015 1017 1018 1019 1020 1021 1023 1024 1025 1026 1027 1028
	1029 1030 1031 1032 1033 1034 1035 1036 1037 1038 1039 1040 1041 1042 1043 1044 1045
	1046 1047 1048 1049 1050 1051 1052 1053 1054 1055 1056 1057 1058 1059 1060 1061 1062
	1063 1064 1065 1066 1067 1068 1069 1070 1071 1073 1074 1075 1076 1818
	1819 1820 1825 1830 1832 1835 1837 1839 1843
	1847 1852 3250 3623
	4326 4327 4282 4283 4284 4973 4974 4975 4976 4977 4978 4979 4980 4981 4982 4983 5113 5114 5115 5116 5117 5118
	#An Island
	1248	
	#New stuff
	1840 1844 1845 1849 1854 1855 1967 1968 1969 364
	2598
	3137 3138 3139 3140 3141 3142 3143 3144
	#MandateOfHeaven
	3885 3886 3887 3888 3889 3890 3891 3892 3893 3894 3895 3896 3897 3898 3899 3900
	3901 3902 3903 3904 3905 3906 3907 3908 3909 3910 3911 3912 3913 3914 3915 3916
	3917 3918 3919 3920 3921 3922 3923 3924 3925 3926 3927 3928 3929 3930 3931 3932
	3933 3934 3935
	
	1371 #Canton Tradenode
	1400 #Philippines Tradenode
	1365 #Siam
	1361 #Malacca
	1376 #Nippon
	1343 #Ganges
	1340 #comorin
	1335 #basra
	
	2369 2357 2354 2360 2355 2368 2364 2356 2363 2350 2349 2370 2352 2358 2353 2351 2359 1781 1782
	2362 2361 1966
	2426 2740 3954
	4322 4323 4324 4325
	
	
	#Siberian New Province
	1072 2427 2428 2429 2430 2431 2432 2433 2434 2435 2436 2437 2438 2439 2440 2442 2443 2445 2446
	4319 4320 4321 4328 4329 4330 4331 4332 4335

	3400 3401 3402 3403 3404 3405 3406 3407 3408 3409  3414 3415 3329 3330
	#
	3340 3341 3342 3343 3344 3345 3346 3347 3348 3349
	3350 3351 3352 3353 3354 3416 3417 3418 3419 3420 3421 3422
	3423 3424 3425 3426 3427 3428 3429 3430 3431 3432 3433 3359 3360 3361 3362 3363 3364 3365 3366 3367 3368
	3369 3370 3371 3372 3574 3505 3607 3608 3609 3610 3611 3612 3613 3614 3615 3616 3617 3618 3619 3620 3621
	3373 3374 3375 3376 3377 3378 3379 3380 3381 3382 3383 3384 3385 3386 3387 3388 3389 3390 3391 3392 3393 3394 3395 3396
	3397 3398 3399 3434 3435 3436 3437 3438 3439 3440 3441 3442 3443 3444 3445 3446 3447 3448 3449 3450 3451 3452 3453 3454
	3455 3456 3457 3458 3459 3460 3461 3462 3463 3464 3465 3466 3467 3468 3469 3470 3471 3472 3473 3474 3475 3476
	3624 3625 3626 3627 3628 3629 3630 3631 3632 3633 3634 3635 3636 3637 3638 3639
	3640 3641 3642 3643 3644 3645 3646 3647 3648 3649 3650 3651 3652 3653 3654 3655 3656 3657
	3658 3659 3660 3661 3662 3663 3664 3666 3668 3670 3671 3672 3673 3675
	3677 3678 3679 3680 3681 3682 3683 3684 3685 3686 3687 3688 3689 3690 3691 3692 3693 3694 3695 3696 3697 3698 3699
	3700 3701 3702 3703 3704 3705 3706 3707 3708 3711 3740 3743 3747 3748 3754 3755 3756 3507 3483 3484
	3810 3813 3814 3815 3816 3817 3818 3820
}

africa = {
	4025
	3968 3969 3970 3971 3973 3974 3975 3976 3977 3978 3979 3980 3981 3982 3983 3984 3985 3988 3989 3990 3987
	3986
	3873 3868 3869 3870 3871 3872 3858 3768 3567 3866 3864 3863 3862 3867
	3878 3874 3875 3876 3877
	3832 3831 3830 3829 3828
	3835 3834 3833
	366 368 3884
	#North Africa
	334 335 336 337 338 339 340 341 342 343 344 345 346 347 348 349 350 351 352 353 354
	355 356 357 358 359 360 361 362 363 365 1751 1793 1794 1795 1882
	2315 2316 2317 2318 2319 2320 2321 2322 2323 2324 2325 2326
	2448 2449 2450 2451 2452 2453 2454 2455 2456 2457 2458 2459 2460
	2461 2462 2463 2464 2465 2466 2467 2468 2469 2470 2472 2473
	2474 2475
	5010 5011 5012
	#Various Islands
	1096 1097 1098 1099 1100 1101 1102 1103 1792
	#Most of Africa
	1110 1111 1112 1113 1114 1115 1116 1117 1118 1119 1120 1121 1122 1123 1124 1125 1126
	1127 1128 1129 1130 1131 1132 1133 1134 1135 1136 1137 1138 1139 1140 1141 1142 1143
	1144 1145 1146 1147 1148 1149 1150 1151 1152 1153 1154 1155 1156 1157 1158 1159 1160
	1161 1162 1163 1164 1165 1166 1167 1169 1170 1171 1172 1173 1174 1175 1176 1177
	1178 1179 1180 1181 1182 1183 1184 1185 1186 1187 1188 1189 1190 1191 1192 1193 1194
	1195 1196 1197 1198 1199 1200 1201 1202 1203 1204 1205 1206 1207 1208 1209 1210 1211
	1212 1213 1214 1215 1216 1217 1218 1219 1220 1221 1222 1223 1224 1225 1226 1227 1228
	1229 1230 1231 1232 1233 1234 1249 1796 1797 1798 1799 1800 1801
	#New overhaul provinces
	774 788 789 833 2237 2238 2239 2240 2241 2242 2243 2244 2245 2246 2247 2248 2249 2250 2251 2252
	2253 2254 2255 2256 2257 2258 2259 2260 2261 2262 2263 2264 2265 2266 2267 2268 2269
	2270 2271 2272 2273 2274 2275 2276 2277 2278 2279 2280 2281 2282 2283 2284 2285 2286
	2287 2288 2289 2290 2291 2292 2293 2294 2295 2756 2757 2758 2759 2760 2761 2762 2763
	2764 2765 2766 2767 2768 2769 2770 2771 2772 2773 2774 2775 2776 2777 2778 2779 2780
	2781 2782 2783 2784 2785 2786 2787 2788 2789 2790 2791 2792 2793 2794 2795 2796 2797
	2798 2799 2800 2801 2802 2856 2864 2880 2932
	1901 2948 2949 3770 3771 3772 3773 3774 3769 3203 3201 3859 3860 3861 3865
	798 1168 2950 2951 2952 2954 1306
	
	1460 #Cape of Good Hope	 TradeNode
	1463 #congo tradenode
	1331 #gulf of aden
	1448 #Zanzibar
	1466 #Ivory
	1470 #mauretanian
	2024
	3266
	3315 3316 3317 3318 3319 3320 3321 3322 3323 3324 3325 3326 3327 3328 3268 3269 3267
	3270 3271 3272 3300 3299 3298 3297 3296 3295 3294 3301 3302 3303 3309 3304 3305 3310 3306
	3307 3311 3312 3308 3313 3314 3292 3293 3291
	3331 3332 3333 3334 3335 2508 2009
	3336 2602 2606 2509 3500 3501 3502 3503 3504 3508 3509 3510 3511 3512 3513 3514 3515 3516 3517
	3518 3519 3520 3521 3522 3523 3524 3525 3526 3527 3528 3529 3530 3531 3532 3533 3534 3535 3536 3537 3538 3539
	3540 3541 3542 3543 3544 3545 3546 3547 3548 3549 3550 3551 3552 3553 3554 3555 3556 3557 3558 3559 3560 3561
	3562 3563 3564 3565 3566 3568 3570 3571 3575 3576 3577 3578 3579 3580 3581 3582 3583 3584 3585 3586 3587
	3588 3589 3590 3591 3592 3593 3594 3595 3596 3597 3598 3599 3600 3601 3602 3603 3604 3605 3606 3572 2510 2505
	3709 3710 3712 3713 3714 3715 3716 3717 3718 3719 3720 3721 3757
	3824 3825 3826 3827 4003 4004 4005
	4539 4540 4541 4542 4543 4544 4545 4546 4547 4548 4549 4550 4551 4552 4553 4554 4555 4556 4557 4558 4559 4560
	4561 4562 4563 4564 4565 4566 4567 4568 4569 4570 4571 4572 4573 4574 4575 4576 4577 4578 4579 4580 4581 4582
	4583 4584 4585 4586 4587 4588 4589 4590 4591 4592 4593 4594 4595 4596 4597 4598 4599 4600 4601 4602 4603 4604
	4605 4606 4607 4608 4609 4610 4611 4612 4613 4614 4615 4616 4617 4618 4619 4620 4621 4622 4623 4624 4625 4626
	4627 4628 4629 4630 4631 4632 4633 4634 4635 4636 4637 4638 4639 4640 4641 4642 4643 4644 4645 4646 4647 4648 4649 4650
	4651 4652 4653 4654 4655 4656 4657 4658 4659 4660 4661 4662 4663 4664 4665 4666 4667 4668 4669 4670 4671 4672
	4673 4674 4675 4676 4677 4678 4679 4680 4681 4682 4683 4684 4685 4686 4687 4688 4689 4690 4691 4692 4693 4694
	4695 4696 4697 4698 4699 4700 4701 4702 4703 4704 4705 4706 4707 4708 4709 4710 4711 4712 4713 4714 4715 4716
	4717 4718 4719 4720 4721 4722 4723 4724 4725 4726 4727 4728 4729 4730 4731 4732 4733 4734 4735 4736 4737 4738
	4739 4740 4741 4742 4743 4744 4745 4746 4747 4748 4749 4750 4751 4752 4753 4754 4990 4991 4992 4993 4994 4995
	4996
	4898 4899 4900 4912 4913 4989 5016 5123
}

north_america = {
	835 836 2663 2664 2819  497 498 499 500 501 3355 3356 837 838 2660 2661 839 840 2637 2640 2662 841 842 
	843 2636 2653 845 846 2633 2634 2650 2651 2652 481 482 483 487 493 494 495 496 1881 488 489 490 492 2658 
	2659 484 485 486 2654 2655 2656 1814 2900 2632 2635 2638 2600 2595 3788 844 847 2629 2646 2649 849 2627 2645 
	2648 850 852 853 2626 2628 2644 848 2630 2631 2641 2647 851 2622 2623 2624 2643 854 2617 2621 2657 856 857 
	2615 2642 858 861 2614 2619 2668 860 863 864 2618 855 859 862 2616 865 866 2620 880 881 2492 2495 867 876 
	877 879 2491 875 878 2493 2494 868 871 869 2021 2476 2477 3879  870 2478 2479 2480 1809 872 2481 2482 2483 873
	2019 2020 2489 2490 889 2506 2507 2625 2006 2501 2502 2503 890 891 892 898 901 903 904 905 906 907 908 909 
	2007 2512 2008 2498 2499 2666 2667 883 884 887 888 2665 2669 895 882 885 886 2496 2497 2500 893 894 897 2014 2516
	900 902 2513 2514 896 899 2515 918 919 920 939 2528 2529 921 922 923 2530 2533 924 925 2531 2532 926 927 928 2534 
	2535 2536 1813 910 911 912 913 2517 2518 914 915 916 917 2519 2520 942 2524 2523 943 934 940 941 2526 944 945 2521 
	2522 931 935 936 951 2527 2548 2551 929 930 2537 2538 2539 2540 946 947 948 2525 949 2011 2552 2553 2544 933 937 
	2541 2545 2549 932 938 2542 2543 2546 2547 950 952 953 2550 2554 2005 955 2555 2556 2557 954 958 959 960 961 964 
	2559 3881 956 957 962 2023 2504 1005 1006 1009 2592 2594 966 967 2010 2560 2562 969 971 2563 2564 2565 2566 2567
	968 970 2013 2561 982 984 2568 2569 983 985 2570 2571 2572 986 2012 2582 2583 980 981 2573 3337 995 996 2576 2577 
	2578 997 2574 2575 990 993 994 2584 992 2579 2580 2581 991 963 965 2558 2639 2599 987 989 2585 2670 988 2586 2587 
	2671 3880 998 999 1000 1002 1003 1004 2588 2589 2590 2591 1001 1007 2015 1008 1010 2016 2511 2593 1011 2017 2596 
	2597 2004 2018 2003 2486 2487 2488 874 2484 2485 972 973 2610 2604 2605 2607 2603 974 975 2022 2609 976 977 978 
	979 2608 2611 2612 2613 2601 1805 1806 1807 1808 1810 1811 1812
	3789 3790
	4802 4803 4804 4805 4806 4807 4808 4809 4810 4811 4812 4813 4814 4815 4816 4817 4818 4822 4823 4824 4825 4826 4856 4857
	4914 4915 4916 4917 4918 4926
}

south_america = {
	2857 2879 2884 2887 2871 2901 759 765 2891 2892 2894 2898 2899 758 2906 2907 2908 2909 2910 2911 2919
	2881 2888 2893 2905 2920 2902 766 768 769 2895 2896 2897 2903 762 763 764 756 757 760 761 2914 2916
	750 751 753 754 755 2912 2921 2922 2867 2885 2913 2915 2917 2918 749 752 2886 2923 2924 2925 2926 2927
	747 748 2890 2928 2929 2935 2938 2889 2930 2933 2934 775 776 799 2882 2883 780 782 786 2868 2869 2870 2876
	785 2843 2844 2845 2847 2872 2877 779 2860 2861 2865 2866 777 778 2846 2848 2849  2853 2855 2858 2859
	791 794 2836 2837 2839 2842 790 2854 2878 772 773 2850 2851 2852 743 744 745 746 2803 2937 3410 742 2804 
	2811 2931 815 816 817 818 819 820 821 2002 2820 491 741 830 831 2807 2808 2813 3357 834 2805 2809 2810 2939 
	2812 2814 2815 824 825 827 832 2817 822 823 2818 2816 828 829 2806 2904	792 793 796 2840 2841 784 787 2862 2875
	783 2873 2874 802 804 2831 2947 805 806 807 808 2828 2829 2830 812 2821 2822 2826 2823 2944 2945 813 2824 2825 2943
	809 810 811 814 2827 800 801 803 2832 2833 2834 795 797 2835 2936 2838 2940 2941 2942 2946 826 502 1095 2025 3741
	1802 1803
	4771 4773 4774 4775 4776 4777 4778 4779 4780 4782 4783 4784 4787 4785 4786 4788 4789 4790 4791 4792 4793
	4794 4795 4796 4797 4798 4799 4800 4801 
	4819 4820 4821 4827 4828 4829 4830 4831 4832 4833 4834 4835 4836 4837 4838 4839
	4840 4841 4842 4843 4844 4845 4846 4847 4848 4849 4850 4851 4852 4853 4854 4855 4919 4920 4921 4922 4923 4924 4925
}

oceania = {
	#Australia
	1084 1085 1086 1087 1088 1089 1090 1091 1092 1093 1094 1790 1791
	#New Zealand
	1106 1107 1108 1109 3339 1783
	#Islands and places like that
	1235 1236 1237 1238 1239 1240 1241 1242 1243 1244 1245 1246 1789
	1986 1987 1988 1989 1990 1991 1992 1993 1994 1995 1996 1997
	1998 1999 3338 3506
	2718 2719 2720 2721 2722 2723 2724
	2726 2727 2728 2729 2730 2731 2732 2733 2734 2735 2736
	2737 2738 2739 3730 3731 3732 3733 3734 3735 3736 3737 3738 3739 3573
	1412 #Australia Tradenode
	3358
	4755 4756 4757 4759 4761 4762 4763 4764 4765 4766
}

island_check_provinces = {			#BT note - WtH is this for?
	4012 # Bitlis- Europe/Asia/Africa
	852  # Mexico - America
	1084 # Wadjuk - West Australia
	1092 # Bundjalung - East Australia
	2728 # Tiwi - North Australia
}

# Used for RNW
new_world = {
}